Bodunovko	Bodunovko|pipa7@sexpusik.info|Bubble Newbies|0|
arshi	arshi|rarshia@gmail.com|Bubble Newbies|0|
buysoma77	buysoma77|sexywoman7@yahoo.com|Bubble Newbies|0|
Medicine_and_Health	Medicine and Health|rewaga@km.ru|Bubble Newbies|0|
GORODradosti	GORODradosti|pont@buy-24h.net.ru|Bubble Newbies|0|
DOCTORWEBBSIG	DOCTORWEBBSIG|mika@buy-24h.net.ru|Bubble Newbies|0|
Eustoss	Eustoss|scrudge@bigmir.net|Bubble Newbies|0|
BritneyloverII	BritneyloverII|britneyloverii@mail.ru|Bubble Newbies|0|
goororinbaf	goororinbaf|mur@buy-24h.net.ru|Bubble Newbies|0|
dooddemewmets	dooddemewmets|moher@amorki.pl|Bubble Newbies|1|
khushbu	khushbu|gkhushbu84@gmail.com|Bubble Newbies|1|
SusanSazzios	SusanSazzios|bigforums@hotpop.com|Bubble Newbies|0|
anwar	Anwar|anwar.mulani@gmail.com|Bubble Newbies|0|
Shubhra	Shubhra|shubhra_nandi@symantec.com|Bubble Newbies|0|
sun	Sun|sundeep.techie@gmail.com|Administrator|1|
dugmentorweb	dugmentorweb|mozg@buy-24h.net.ru|Bubble Newbies|0|
allaboutsexcomporno	allaboutsexcomporno|door555555@mail.ru|Bubble Newbies|0|
ArielVideoEX	ArielVideoEX|farina@refinancce.biz|Bubble Newbies|0|
valacyclovir	valacyclovir|ilya_sitkov@mail.ru|Bubble Newbies|0|
affdatingman	affdatingman|affdating1info@mail.ru|Bubble Newbies|0|
OFFLEASE-RU	OFFLEASE-RU|usedit@mail.ru|Bubble Newbies|0|
MultyNuty	MultyNuty|mumltrytu@bigmir.net|Bubble Newbies|1|
Faisal	Faisal|faisalgroup@indiatimes.com|Bubble Newbies|0|
ninetyninfe	ninetyninfe|ninetyninfe@mail.ru|Bubble Newbies|0|
aby	aby|abhi4u82@gmail.com|Administrator|1|
heaggendy	heaggendy|wenruptweft@mail.ru|Bubble Newbies|0|
TearIzUp	TearIzUp|robamplan@yahoo.com|Bubble Newbies|0|
WhiteLedi	WhiteLedi|jessica1991@gawab.com|Bubble Newbies|0|
ram_ranu11	ram_ranu11|ram_renu11@rediffmail.com|Bubble Newbies|0|
rajiv_nayak	rajiv_nayak|rajiv_nayak@symantec.com|Bubble Newbies|0|
Fasetmcmvf	Fasetmcmvf|bobrider@diet-us.info|Bubble Newbies|0|
PrathimaReddyD	PrathimaReddyD|prathimareddyd@gmail.com|Bubble Newbies|0|
KatieSventy	KatieSventy|newlz@quest-source.com|Bubble Newbies|0|
dandeyagna	dandeyagna|yagnanarayana_dande@symantec.com|Bubble Newbies|0|
vinca	vinca|razikh@gmail.com|Bubble Newbies|0|
Zalivaika	Zalivaika|rxnicse@bigmir.net|Bubble Newbies|0|
DanyXaserom	DanyXaserom|danis@casinoi.biz|Bubble Newbies|0|
MizeIrraree	MizeIrraree|dxy8o8p@web-pharmacy-rx.info|Bubble Newbies|0|
tameem	tameem|tameemahmed.khan@gmail.com|Bubble Newbies|0|
Clortumisss	Clortumisss|clortumisss@gmail.com|Bubble Newbies|0|
srivastava.ekta	ekta|srivastava.ekta@gmail.com|Bubble Newbies|0|
vwcenter	vwcenter|licicac@bigmir.net|Bubble Newbies|0|
camscomweb	camscomweb|camscom1@mail.ru|Bubble Newbies|0|
danybrown	danybrown|danybrown@gawab.com|Bubble Newbies|0|
admin	Bubble Forum Admin|admin@bubble.co.in|Administrator|1|
kedardonthi	Kdar|kedardonthi@gmail.com|Bubble Newbies|0|
OEIISJJEsjjz	OEIISJJEsjjz|lesbiansexpics@hotpop.com|Bubble Newbies|0|
alixsvetlasha	alixsvetlasha|ladiach_esmira@mail.ru|Bubble Newbies|0|
garillasnet	garillasnet|job@buy-24h.net.ru|Bubble Newbies|0|
vishalbarde	vishalbarde|richie_techin@yahoo.co.in|Bubble Newbies|0|
cash007	cash007|login@gawab.com|Bubble Newbies|0|
kuldeep	kuldeep|kuldeepadhikari@yahoo.com|Bubble Newbies|0|
razikh	razikh|razikh@bubble.co.in|Administrator|1|
shariffhu	shariffhu|shariff_gates@yahoo.co.in|Bubble Newbies|0|
Bobononoll	Bobononoll|bobononoll@phreaker.net|Bubble Newbies|0|
bosjacovich	bosjacovich|zec@buy-24h.net.ru|Bubble Newbies|0|
reduntex	reduntex|thatkid@kzro.net|Bubble Newbies|0|
GENNAWCHOT	GENNAWCHOT|cos@buy-24h.net.ru|Bubble Newbies|0|
gandonofil	gandonofil|bin@buy-24h.net.ru|Bubble Newbies|0|
ranoutrom	ranoutrom|boc@buy-24h.net.ru|Bubble Newbies|0|
vafforinnor	vafforinnor|con@buy-24h.net.ru|Bubble Newbies|0|
ArinaLionS	ArinaLionS|afitab@vip-us.info|Bubble Newbies|0|
wasp	wasp|wasp2727@yahoo.co.in|Bubble Newbies|0|
Yandomm	Yandomm|ydms2007@bigmir.net|Bubble Newbies|0|
